**************************************
*         *       *    *             *
******    *  ***  *    *              *
*    *    *       *  *                *
*    *   ***   *  *  *                 *
*    *    *    *  *  *       ***        *
*S   *         *     *       *          *
*   ***   **   *  *  *       ***        *
**   *******   *  *  *                  *
*              *  *                     *
* ******       *  *  *                 *
*             **  *  *                *
**** ******** **     *                *
*              *  *  *                *
*********      *  *                   *
*              *  **                  *
*              *                      *
***************************************
